"1","1","21","19"
"2","2","21","19"
"3","3","21","19"
"4","4","21","19"
"5","5","21","19"
